*************************
S *     *   *         * *
* * *** * * * * ***** * *
*   *     *   *    P*   *
***************** *******
*     *                 *
* *** * *********** *****
*   *K*   *E*     *     *
*** ***** * * *** *** ***
*         *   *         *
*************************