******E    ************
*S   *****         ****
**** ***** ** ****  P**
**** *****K** **** ****
****      ******** ****
********             **
***********************