.......................
.......................
.......................
............xx...xx....
............x......x...
....xxxx..xx........x..
...x.................x.
..x...................x
xxxxxxxxxxxxxxxxxxxxxxx