............................
...........x................
...........x................
...........x.x..............
...........x.x..............
...........x.x..............
...........x.x..............
xxxxxxxxxxxxxxxxxxxxxxxxxxxx