******E    ************
*S   *****         ****
**** ***** ** ****  P**
**** *****K** **** ****
****      ******** ****
*********            **
***********************